5 1
11111111111
10000000001    
10011011001
10011011001
10011011001
10011111001
10000000001
11111111111